50 50
-1 -2 -1 -2 -3 -2 -3 -2 -3 -3 -3 -3 -1 -1 -1 -1 -1 -1 -1 -2 -1 -1 -1 -1 -1 -1 -1 -2 -3 -3 -3 -2 -1 -2 -3 -3 -3 -2 -2 -1 -1 -1 -1 -1 -1 -1 -1 -1 -1 -2 
-1 -2 -1 -2 -3 -2 -3 -2 -2 -2 -2 -2 -2 -2 -1 -1 -3 -1 -1 -3 -1 -2 -2 -2 -2 -2 -1 -2 -3 -1 -3 -2 -1 -3 -3 -1 -3 -2 -1 -2 -1 -3 -1 -1 -1 -1 -3 -1 -2 -1 
-1 -2 -1 -1 -1 -1 -1 -1 -1 -1 -1 -2 -3 -2 -1 -1 -1 -1 -1 -2 -1 -2 -3 -3 -3 -2 -1 -2 -3 -3 -3 -2 -1 -2 -3 -3 -3 -2 -1 -1 -2 -1 -1 -3 -3 -1 -1 -2 -1 -1 
-1 -2 -2 -2 -2 -2 -2 -2 -2 -2 -1 -2 -1 -2 -2 -2 -2 -2 -2 -2 -1 -2 -3 -1 -3 -3 -1 -2 -2 -3 -2 -2 -1 -2 -2 -2 -2 -2 -1 -3 -1 -2 -1 -3 -3 -1 -2 -1 -3 -1 
-1 -1 -1 -1 -3 -1 -1 -1 -1 -2 -1 -2 -1 -2 -3 -2 -3 -1 -2 -1 -1 -2 -3 -3 -3 -2 -1 -1 -1 -1 -1 -1 -1 -1 -1 -1 -1 -3 -1 -1 -1 -1 -2 -1 -1 -2 -1 -1 -1 -1 
-3 -2 -2 -2 -2 -2 -2 -2 -1 -2 -1 -2 -1 -2 -1 -2 -1 -1 -2 -1 -1 -2 -2 -2 -2 -2 -1 -2 -2 -2 -2 -2 -1 -2 -2 -3 -2 -2 -1 -1 -3 -3 -1 -3 -3 -1 -3 -3 -1 -1 
-3 -2 -4 -4 -4 -4 -4 -2 -1 -2 -1 -2 -1 -2 -1 -2 -3 -1 -3 -1 -1 -1 -1 -1 -1 -1 -1 -2 -3 -3 -3 -2 -1 -2 -3 -3 -3 -2 -1 -1 -3 -3 -1 -3 -3 -1 -3 -3 -1 -1 
-3 -2 -4 -2 -3 -2 -3 -2 -1 -2 -1 -1 -1 -1 -1 -2 -1 -1 -2 -1 -2 -2 -2 -2 -2 -1 -2 -2 -3 -1 -3 -3 -1 -2 -3 -1 -3 -2 -1 -1 -1 -1 -2 -1 -1 -2 -1 -1 -1 -1 
-2 -2 -4 -2 -1 -2 -3 -2 -3 -2 -2 -2 -3 -2 -2 -2 -3 -1 -2 -1 -2 -3 -3 -3 -2 -1 -2 -2 -3 -3 -3 -2 -1 -2 -3 -3 -3 -2 -1 -3 -1 -2 -1 -3 -3 -1 -2 -1 -3 -1 
-4 -4 -4 -2 -1 -2 -3 -2 -1 -2 -4 -4 -3 -4 -4 -4 -2 -4 -2 -1 -3 -3 -1 -3 -2 -1 -2 -2 -2 -2 -2 -2 -2 -2 -2 -2 -2 -2 -1 -1 -2 -1 -1 -3 -3 -1 -1 -2 -1 -1 
-4 -3 -4 -2 -1 -2 -2 -2 -1 -2 -4 -4 -4 -4 -4 -4 -2 -4 -2 -1 -2 -3 -3 -3 -2 -1 -2 -4 -4 -4 -4 -4 -4 -4 -2 -2 -2 -2 -1 -2 -1 -3 -1 -1 -1 -1 -3 -1 -2 -1 
-4 -3 -4 -2 -1 -1 -1 -1 -1 -2 -1 -4 -4 -4 -1 -4 -2 -3 -2 -1 -2 -2 -2 -2 -2 -1 -3 -1 -2 -2 -2 -2 -2 -4 -4 -4 -4 -2 -2 -1 -1 -1 -1 -1 -1 -1 -1 -1 -1 -2 
-4 -4 -4 -2 -2 -2 -2 -2 -2 -2 -1 -4 -4 -4 -1 -4 -4 -4 -2 -1 -1 -1 -1 -1 -1 -1 -2 -1 -1 -1 -1 -1 -2 -2 -2 -2 -4 -2 -2 -2 -2 -2 -2 -3 -2 -2 -2 -2 -2 -2 
-3 -1 -1 -4 -4 -3 -2 -4 -1 -1 -3 -1 -3 -1 -3 -1 -1 -4 -2 -2 -2 -2 -2 -2 -2 -2 -2 -1 -1 -1 -3 -1 -1 -1 -1 -2 -4 -4 -4 -4 -4 -4 -2 -1 -2 -1 -3 -1 -1 -1 
-1 -3 -1 -1 -4 -4 -3 -4 -1 -3 -1 -3 -1 -3 -1 -3 -1 -4 -2 -3 -1 -1 -1 -1 -1 -1 -1 -3 -1 -1 -1 -1 -1 -1 -1 -3 -2 -3 -2 -3 -2 -4 -2 -1 -2 -3 -1 -1 -1 -3 
-1 -1 -3 -1 -1 -4 -4 -4 -4 -4 -4 -4 -4 -4 -4 -4 -4 -4 -2 -1 -1 -1 -3 -1 -1 -1 -1 -1 -1 -1 -3 -1 -1 -2 -2 -2 -3 -2 -3 -2 -3 -4 -2 -1 -2 -3 -1 -1 -1 -1 
-4 -1 -1 -3 -1 -1 -4 -4 -1 -1 -1 -1 -3 -1 -1 -1 -1 -4 -2 -1 -1 -1 -1 -3 -1 -1 -3 -1 -1 -1 -1 -1 -1 -2 -4 -4 -4 -4 -4 -4 -4 -4 -2 -1 -2 -1 -3 -1 -1 -3 
-4 -4 -1 -1 -3 -1 -1 -4 -4 -1 -1 -1 -1 -1 -1 -1 -4 -4 -2 -2 -2 -2 -3 -1 -1 -1 -1 -1 -1 -1 -1 -1 -3 -2 -4 -2 -2 -2 -2 -2 -2 -2 -2 -3 -2 -2 -2 -2 -2 -3 
-1 -4 -4 -1 -1 -3 -1 -4 -4 -4 -3 -3 -3 -3 -3 -4 -4 -3 -4 -3 -4 -2 -1 -1 -1 -3 -1 -1 -1 -3 -1 -3 -1 -2 -4 -2 -3 -3 -2 -3 -1 -1 -1 -1 -1 -1 -1 -1 -1 -1 
-3 -1 -4 -4 -1 -1 -3 -4 -4 -1 -1 -1 -1 -1 -1 -1 -4 -4 -2 -2 -3 -2 -1 -2 -2 -2 -2 -2 -2 -2 -2 -2 -1 -2 -4 -2 -3 -3 -2 -2 -2 -2 -2 -2 -3 -2 -2 -2 -2 -2 
-3 -3 -1 -4 -4 -4 -4 -4 -1 -1 -1 -1 -3 -1 -1 -1 -1 -4 -2 -2 -4 -2 -1 -2 -4 -4 -4 -4 -4 -4 -4 -2 -3 -2 -4 -2 -1 -1 -3 -1 -1 -1 -1 -1 -1 -1 -1 -1 -1 -1 
-2 -2 -2 -2 -2 -4 -2 -4 -4 -4 -4 -4 -4 -4 -4 -4 -4 -4 -2 -2 -3 -2 -2 -2 -3 -2 -2 -2 -2 -2 -4 -2 -3 -2 -4 -2 -1 -2 -2 -2 -2 -2 -2 -2 -2 -2 -2 -2 -2 -1 
-4 -4 -4 -4 -4 -4 -2 -2 -2 -2 -2 -2 -2 -2 -2 -2 -2 -2 -2 -2 -4 -2 -3 -3 -3 -3 -3 -3 -4 -2 -4 -2 -2 -2 -4 -2 -1 -3 -1 -1 -1 -3 -1 -1 -1 -3 -2 -1 -1 -1 
-4 -2 -2 -2 -2 -2 -2 -1 -1 -1 -1 -1 -1 -2 -1 -1 -3 -1 -1 -2 -3 -2 -3 -3 -3 -3 -3 -3 -4 -2 -4 -4 -4 -4 -4 -2 -2 -2 -2 -2 -2 -2 -2 -2 -2 -1 -2 -1 -2 -2 
-4 -4 -4 -4 -4 -4 -2 -1 -1 -3 -1 -1 -1 -2 -1 -1 -1 -3 -1 -2 -4 -2 -3 -3 -3 -3 -3 -3 -3 -4 -2 -2 -2 -2 -2 -2 -1 -3 -1 -1 -1 -3 -1 -1 -2 -1 -2 -1 -4 -3 
-2 -2 -2 -2 -2 -4 -2 -1 -3 -1 -3 -1 -1 -3 -1 -1 -1 -1 -3 -2 -4 -3 -3 -3 -3 -3 -3 -3 -2 -4 -2 -3 -1 -3 -1 -3 -1 -2 -2 -2 -2 -1 -2 -1 -2 -1 -2 -3 -2 -2 
-4 -4 -4 -4 -4 -4 -2 -1 -1 -3 -1 -1 -2 -2 -2 -2 -1 -3 -1 -2 -2 -2 -3 -3 -3 -3 -3 -3 -2 -4 -2 -1 -1 -1 -1 -1 -1 -1 -1 -1 -2 -1 -2 -3 -2 -3 -2 -1 -4 -3 
-4 -2 -2 -2 -2 -2 -2 -2 -1 -1 -1 -1 -2 -3 -1 -2 -1 -1 -3 -1 -1 -2 -3 -3 -3 -3 -3 -3 -2 -4 -2 -2 -2 -2 -2 -2 -1 -3 -1 -3 -2 -1 -2 -1 -2 -1 -2 -3 -2 -2 
-4 -2 -3 -3 -3 -4 -4 -2 -1 -1 -2 -2 -2 -3 -1 -2 -1 -1 -1 -3 -1 -2 -2 -2 -2 -3 -4 -2 -2 -4 -4 -4 -4 -4 -4 -2 -2 -1 -1 -1 -2 -3 -2 -1 -2 -1 -2 -1 -4 -3 
-4 -2 -2 -2 -2 -2 -4 -2 -1 -1 -2 -1 -1 -3 -3 -4 -4 -4 -4 -4 -1 -1 -1 -1 -2 -1 -2 -3 -2 -2 -2 -2 -2 -2 -4 -4 -2 -2 -2 -2 -2 -1 -2 -1 -2 -1 -2 -3 -2 -2 
-4 -4 -4 -4 -4 -4 -4 -2 -1 -1 -2 -1 -1 -3 -1 -2 -1 -1 -1 -4 -1 -1 -1 -1 -2 -1 -2 -3 -3 -3 -3 -3 -3 -3 -2 -3 -1 -1 -1 -3 -1 -1 -2 -3 -2 -3 -2 -1 -4 -3 
-2 -2 -2 -3 -2 -4 -2 -2 -2 -3 -2 -1 -1 -3 -1 -2 -1 -1 -1 -4 -1 -1 -1 -1 -2 -1 -1 -2 -2 -2 -2 -2 -2 -3 -2 -1 -2 -2 -2 -2 -2 -2 -2 -1 -2 -1 -2 -3 -2 -2 
-3 -2 -1 -1 -2 -4 -3 -1 -1 -1 -2 -2 -2 -2 -2 -2 -1 -3 -1 -4 -4 -4 -4 -4 -4 -4 -1 -1 -1 -1 -1 -3 -1 -2 -1 -1 -2 -3 -3 -1 -1 -1 -3 -1 -2 -1 -2 -1 -4 -3 
-3 -2 -1 -1 -2 -2 -2 -1 -1 -1 -1 -1 -1 -3 -1 -1 -1 -1 -1 -4 -2 -2 -2 -2 -2 -4 -1 -1 -1 -1 -1 -1 -2 -1 -1 -1 -2 -3 -3 -2 -2 -2 -2 -2 -2 -1 -2 -1 -2 -2 
-3 -2 -1 -1 -1 -2 -1 -1 -3 -3 -1 -1 -1 -2 -3 -1 -1 -1 -1 -4 -2 -1 -1 -3 -2 -4 -1 -3 -3 -3 -3 -1 -2 -3 -3 -1 -2 -2 -2 -2 -1 -3 -1 -1 -1 -3 -2 -1 -1 -1 
-1 -1 -1 -1 -1 -2 -1 -1 -1 -1 -1 -3 -1 -2 -1 -3 -1 -1 -1 -4 -2 -1 -2 -3 -2 -4 -1 -1 -1 -1 -1 -1 -2 -3 -3 -1 -1 -1 -3 -1 -1 -2 -2 -2 -2 -2 -2 -2 -2 -3 
-1 -3 -1 -2 -3 -2 -2 -2 -2 -1 -1 -3 -1 -2 -1 -1 -3 -1 -3 -4 -2 -2 -2 -3 -2 -4 -3 -1 -1 -1 -1 -1 -2 -2 -2 -2 -2 -2 -2 -2 -2 -1 -1 -1 -1 -1 -2 -2 -1 -1 
-1 -1 -1 -2 -1 -1 -1 -1 -2 -1 -1 -1 -1 -2 -1 -1 -1 -1 -1 -4 -4 -4 -4 -4 -4 -4 -4 -4 -4 -4 -4 -4 -4 -4 -4 -4 -1 -1 -1 -1 -1 -3 -1 -1 -3 -2 -2 -3 -3 -1 
-2 -2 -3 -2 -2 -1 -3 -1 -2 -2 -1 -2 -2 -2 -2 -2 -2 -1 -3 -1 -1 -2 -1 -3 -1 -1 -1 -3 -1 -1 -1 -1 -1 -1 -1 -4 -1 -1 -1 -1 -1 -1 -1 -3 -2 -2 -1 -1 -2 -1 
-1 -1 -1 -1 -2 -1 -3 -1 -1 -2 -2 -2 -1 -1 -1 -1 -2 -2 -2 -2 -2 -2 -1 -1 -1 -3 -1 -1 -1 -1 -3 -1 -1 -1 -3 -4 -4 -1 -1 -1 -1 -1 -3 -2 -2 -1 -1 -2 -2 -3 
-1 -3 -1 -1 -3 -1 -3 -3 -3 -1 -3 -1 -1 -1 -1 -3 -3 -1 -1 -1 -1 -2 -1 -3 -1 -1 -1 -1 -1 -1 -1 -1 -1 -1 -1 -1 -4 -4 -1 -3 -1 -3 -2 -2 -1 -1 -2 -2 -1 -3 
-3 -1 -3 -1 -2 -1 -1 -1 -1 -1 -2 -1 -2 -2 -2 -2 -2 -2 -2 -2 -1 -2 -1 -1 -1 -1 -1 -3 -1 -1 -3 -1 -4 -4 -4 -1 -1 -4 -1 -1 -1 -2 -2 -1 -1 -2 -2 -1 -1 -2 
-1 -3 -1 -2 -1 -1 -1 -2 -2 -2 -2 -2 -1 -1 -1 -1 -1 -1 -3 -2 -3 -2 -1 -1 -1 -1 -1 -1 -1 -1 -1 -2 -3 -2 -4 -1 -4 -4 -1 -1 -2 -2 -1 -1 -2 -2 -1 -1 -2 -2 
-1 -1 -2 -1 -2 -2 -2 -2 -1 -1 -1 -1 -1 -1 -1 -3 -1 -1 -3 -2 -3 -2 -2 -2 -2 -2 -2 -2 -2 -2 -2 -2 -4 -2 -4 -4 -4 -1 -3 -2 -2 -1 -1 -2 -2 -1 -1 -2 -2 -1 
-1 -1 -2 -1 -1 -1 -1 -1 -1 -2 -2 -2 -2 -1 -2 -1 -1 -1 -3 -2 -2 -3 -4 -4 -4 -4 -4 -4 -4 -4 -4 -2 -4 -2 -1 -1 -1 -1 -2 -2 -1 -1 -2 -2 -1 -1 -2 -2 -3 -3 
-2 -3 -2 -1 -2 -2 -2 -2 -2 -2 -3 -2 -1 -1 -2 -1 -1 -2 -2 -2 -1 -2 -4 -2 -2 -2 -2 -2 -2 -2 -4 -2 -4 -2 -3 -1 -1 -2 -2 -1 -1 -2 -2 -1 -1 -2 -2 -1 -1 -1 
-1 -1 -2 -1 -3 -2 -3 -2 -3 -2 -3 -2 -3 -3 -2 -1 -1 -2 -1 -1 -1 -2 -4 -2 -3 -3 -4 -4 -4 -4 -4 -2 -4 -2 -3 -3 -2 -2 -1 -1 -2 -2 -1 -1 -2 -2 -1 -1 -2 -1 
-1 -1 -2 -1 -3 -2 -1 -2 -1 -2 -3 -2 -2 -2 -2 -1 -1 -2 -1 -1 -1 -2 -4 -2 -3 -3 -3 -3 -3 -3 -3 -2 -4 -2 -3 -2 -2 -1 -1 -2 -2 -3 -3 -2 -2 -1 -1 -2 -2 -3 
-1 -1 -2 -2 -2 -2 -1 -2 -1 -2 -1 -1 -1 -1 -1 -1 -2 -2 -1 -2 -2 -2 -4 -2 -2 -2 -2 -2 -2 -2 -2 -2 -4 -2 -2 -2 -3 -3 -2 -2 -1 -1 -2 -2 -3 -1 -2 -2 -3 -1 
-1 -1 -1 -1 -1 -1 -1 -1 -1 -1 -1 -1 -1 -1 -1 -1 -1 -1 -1 -3 -4 -4 -4 -4 -4 -4 -4 -4 -4 -4 -4 -4 -4 -4 -3 -1 -1 -2 -2 -1 -1 -1 -1 -1 -3 -2 -2 -3 -1 -1 

0 0 0 0 40 0 40 0 40 40 40 40 0 0 0 0 0 0 0 0 40 40 40 40 40 40 40 0 40 40 40 0 40 0 40 40 40 0 0 0 0 0 0 0 0 0 0 0 0 0 
0 0 0 0 40 0 40 0 0 0 0 0 0 0 0 0 -9999 0 0 9999 40 0 0 0 0 0 40 0 40 0 40 0 40 40 40 0 40 0 0 0 0 40 0 0 0 0 40 0 0 0 
0 0 0 0 0 0 0 0 0 0 0 0 40 0 0 0 0 0 0 0 40 0 40 40 40 0 40 0 40 40 40 0 40 0 40 40 40 0 0 0 0 0 0 40 40 0 0 0 0 0 
0 0 0 0 0 0 0 0 0 0 0 0 0 0 0 0 0 0 0 0 40 0 40 0 40 40 40 0 0 40 0 0 40 0 0 0 0 0 0 40 0 0 0 40 40 0 0 0 40 0 
0 0 0 0 40 0 0 0 0 0 0 0 0 0 40 0 40 0 0 40 40 0 40 40 40 0 40 40 40 40 40 40 40 40 40 40 40 40 0 0 0 0 0 0 0 0 0 0 0 0 
40 0 0 0 0 0 0 0 0 0 0 0 0 0 0 0 0 0 0 40 40 0 0 0 0 0 40 0 0 0 0 0 40 0 0 40 0 0 0 0 40 40 0 500 500 0 40 40 0 0 
40 0 0 0 0 0 0 0 0 0 0 0 0 0 0 0 40 0 40 40 40 40 40 40 40 40 40 0 40 40 40 0 40 0 40 40 40 0 0 0 40 40 0 500 500 0 40 40 0 0 
40 0 0 0 40 0 40 0 0 0 0 0 0 0 0 0 0 0 0 40 0 0 0 0 0 40 0 0 40 0 40 40 40 0 40 0 40 0 0 0 0 0 0 0 0 0 0 0 0 0 
0 0 0 0 0 0 40 0 40 0 0 0 40 0 0 0 40 0 0 40 0 40 40 40 0 40 0 0 40 40 40 0 40 0 40 40 40 0 0 40 0 0 0 40 40 0 0 0 40 0 
0 0 0 0 0 0 40 0 0 0 0 0 40 0 0 0 0 0 0 40 40 40 0 40 0 40 0 0 0 0 0 0 0 0 0 0 0 0 0 0 0 0 0 40 40 0 0 0 0 0 
0 40 0 0 0 0 0 0 0 0 0 0 0 0 0 0 0 0 0 40 0 40 40 40 0 40 0 0 0 0 0 0 0 0 0 0 0 0 0 0 0 40 0 0 0 0 40 0 0 0 
0 40 0 0 0 0 0 0 0 0 0 0 0 0 0 0 0 40 0 40 0 0 0 0 0 40 2000 0 0 0 0 0 0 0 0 0 0 0 0 0 0 0 0 0 0 0 0 0 0 0 
0 0 0 0 0 0 0 0 0 0 0 0 0 0 0 0 0 0 0 40 40 40 40 40 40 40 0 0 0 0 0 0 0 0 0 0 0 0 0 0 0 0 0 40 0 0 0 0 0 0 
40 0 0 0 0 40 0 0 0 0 40 0 40 0 40 0 0 0 0 0 0 0 0 0 0 0 0 0 0 0 40 0 0 0 0 0 0 0 0 0 0 0 0 0 0 0 40 0 0 0 
0 40 0 0 0 0 40 0 0 40 0 40 0 40 0 40 0 0 0 40 0 0 0 0 0 0 0 40 0 0 0 0 0 0 0 40 0 40 0 40 0 0 0 0 0 40 0 0 0 -9999 
0 0 40 0 0 0 0 0 0 0 0 0 0 0 0 0 0 0 0 0 0 0 40 0 0 0 0 0 0 0 40 0 0 0 0 0 40 0 40 0 40 0 0 0 0 40 0 0 0 0 
0 0 0 40 0 0 0 0 0 0 0 0 40 0 0 0 0 0 0 0 0 0 0 40 0 0 40 0 0 0 0 0 0 0 0 0 0 0 0 0 0 0 0 0 0 0 40 0 0 9999 
0 0 0 0 40 0 0 0 0 0 0 0 0 0 0 0 0 0 0 0 0 0 40 0 0 0 0 0 0 0 0 0 40 0 0 0 0 0 0 0 0 0 0 40 0 0 0 0 0 40 
0 0 0 0 0 40 0 0 0 0 40 40 40 40 40 0 0 2000 0 40 0 0 0 0 0 40 0 0 0 40 0 40 0 0 0 0 40 40 0 40 0 0 0 0 0 0 0 0 0 0 
40 0 0 0 0 0 40 0 0 0 0 0 0 0 0 0 0 0 0 0 40 0 0 0 0 0 0 0 0 0 0 0 0 0 0 0 40 40 0 0 0 0 0 0 40 0 0 0 0 0 
40 40 0 0 0 0 0 0 0 0 0 0 40 0 0 0 0 0 0 0 0 0 0 0 0 0 0 0 0 0 0 0 40 0 0 0 0 0 2000 0 0 0 0 0 0 0 0 0 0 0 
0 0 0 0 0 0 0 0 0 0 0 0 0 0 0 0 0 0 0 0 40 0 0 0 4000 0 0 0 0 0 0 0 40 0 0 0 0 0 0 0 0 0 0 0 0 0 0 0 0 0 
0 0 0 0 0 0 0 0 0 0 0 0 0 0 0 0 0 0 0 0 0 0 40 40 40 40 40 40 0 0 0 0 0 0 0 0 0 40 0 0 0 40 0 0 0 40 0 0 0 0 
0 0 0 0 0 0 0 0 0 0 0 0 0 0 0 0 40 0 0 0 40 0 40 40 40 40 40 40 0 0 0 0 0 0 0 0 0 0 0 0 0 0 0 0 0 0 0 0 0 0 
0 0 0 0 0 0 0 0 0 40 0 0 0 0 0 0 0 40 0 0 0 0 40 40 40 40 40 40 4000 0 0 0 0 0 0 0 0 40 0 0 0 40 0 0 0 0 0 0 0 40 
0 0 0 0 0 0 0 0 40 0 40 0 0 40 0 0 0 0 40 0 0 3000 40 40 40 40 40 40 0 0 0 40 0 40 0 40 0 0 0 0 0 0 0 0 0 0 0 40 0 0 
0 0 0 0 0 0 0 0 0 40 0 0 0 0 0 0 0 40 0 0 0 0 40 40 40 40 40 40 0 0 0 0 0 0 0 0 0 0 0 0 0 0 0 40 0 40 0 0 0 40 
0 0 0 0 0 0 0 0 0 0 0 0 0 40 0 0 0 0 40 0 0 0 40 40 40 40 40 40 0 0 0 0 0 0 0 0 0 40 0 40 0 0 0 0 0 0 0 40 0 0 
0 0 40 40 40 0 0 0 0 0 0 0 0 40 0 0 0 0 0 40 0 0 0 0 0 4000 0 0 0 0 0 0 0 0 0 0 0 0 0 0 0 40 0 0 0 0 0 0 0 40 
0 0 0 0 0 0 0 0 0 0 0 0 0 40 40 0 0 0 0 0 0 0 0 0 0 0 0 -9999 0 0 0 0 0 0 0 0 0 0 0 0 0 0 0 0 0 0 0 40 0 0 
0 0 0 0 0 0 0 0 0 0 0 0 0 40 0 0 0 0 0 0 0 0 0 0 0 0 0 -9999 -9999 -9999 -9999 -9999 -9999 -9999 0 40 0 0 0 40 0 0 0 40 0 40 0 0 0 40 
0 0 0 40 0 0 0 0 0 40 0 0 0 40 0 0 0 0 0 0 0 0 0 0 0 0 0 0 0 0 0 0 0 -9999 0 0 0 0 0 0 0 0 0 0 0 0 0 40 0 0 
40 0 0 0 0 0 2000 0 0 0 0 0 0 0 0 0 0 40 0 0 0 0 0 0 0 0 0 0 0 0 0 40 0 0 0 0 0 40 40 0 0 0 40 0 0 0 0 0 0 40 
40 0 0 0 0 0 0 0 0 0 0 0 0 40 0 0 0 0 0 0 0 0 0 0 0 0 0 0 0 0 0 0 0 0 0 0 0 40 40 0 0 0 0 0 0 0 0 0 0 0 
40 0 0 0 0 0 0 0 40 40 0 0 0 0 40 0 0 0 0 0 0 0 0 40 0 0 0 40 40 40 40 0 0 40 40 0 0 0 0 0 0 40 0 0 0 40 0 0 0 0 
0 0 0 0 0 0 0 0 0 0 0 40 0 0 0 40 0 0 0 0 0 0 0 40 0 0 0 0 0 0 0 0 0 40 40 0 0 0 40 0 0 0 0 0 0 0 0 0 0 40 
0 40 0 0 40 0 0 0 0 0 0 40 0 0 0 0 40 0 40 0 0 0 0 40 0 0 40 0 0 0 0 0 0 0 0 0 0 0 0 0 0 0 0 0 0 0 0 0 0 0 
0 0 0 0 0 0 0 0 0 0 0 0 0 0 0 0 0 0 0 0 0 0 0 0 0 0 0 0 0 0 0 0 0 0 0 0 0 0 0 0 0 40 0 0 40 0 0 40 40 0 
0 0 40 0 0 0 40 0 0 0 0 0 0 0 0 0 0 0 40 0 0 0 0 40 0 0 0 40 0 0 0 0 0 0 0 0 0 0 0 0 0 0 0 40 0 0 0 0 0 0 
0 0 0 0 0 0 40 0 0 0 0 0 0 0 0 0 0 0 0 0 0 0 0 0 0 40 0 0 0 0 40 0 0 0 40 0 0 0 0 0 0 0 40 0 0 0 0 0 0 40 
0 40 0 0 40 0 40 40 40 0 40 0 0 0 0 40 40 0 0 0 0 0 0 40 0 0 0 0 0 0 0 0 0 0 0 0 0 0 0 40 0 40 0 0 0 0 0 0 0 40 
40 0 40 0 0 0 0 0 0 0 0 0 0 0 0 0 0 0 0 0 0 0 0 0 0 0 0 40 0 0 40 0 0 0 0 0 0 0 0 0 0 0 0 0 0 0 0 0 0 0 
0 40 0 0 0 0 0 0 0 0 0 0 0 0 0 0 0 0 40 0 40 0 0 0 0 0 0 0 0 0 0 0 2000 0 0 0 0 0 0 0 0 0 0 0 0 0 0 0 0 0 
0 0 0 0 0 0 0 0 0 0 0 0 0 0 0 40 0 0 40 0 40 0 0 0 0 0 0 0 0 0 0 0 0 0 0 0 0 0 40 0 0 0 0 0 0 0 0 0 0 0 
0 0 0 0 0 0 0 0 0 0 0 0 0 0 0 0 0 0 40 0 0 40 0 0 0 0 0 0 0 0 0 0 0 0 0 0 0 0 0 0 0 0 0 0 0 0 0 0 40 40 
0 40 0 0 0 0 0 0 0 0 40 0 0 0 0 0 0 0 0 0 0 0 0 0 0 0 0 0 0 0 0 0 0 0 40 0 0 0 0 0 0 0 0 0 0 0 0 0 0 0 
0 0 0 0 40 0 40 0 40 0 40 0 40 40 0 0 0 0 0 0 0 0 0 0 40 40 0 0 0 0 0 0 0 0 40 40 0 0 0 0 0 0 0 0 0 0 0 0 0 0 
0 0 0 0 40 0 0 0 0 0 40 0 0 0 0 0 0 0 0 0 0 0 0 0 40 40 40 40 40 40 40 0 0 0 40 0 0 0 0 0 0 40 40 0 0 0 0 0 0 40 
0 0 0 0 0 0 0 0 0 0 0 0 0 0 0 0 0 0 0 0 0 0 0 0 0 0 0 0 0 0 0 0 0 0 0 0 40 40 0 0 0 0 0 0 40 0 0 0 40 0 
0 0 0 0 0 0 0 0 0 0 0 0 0 0 0 0 0 0 0 40 0 0 0 0 0 0 0 0 0 0 0 0 0 0 40 0 0 0 0 0 0 0 0 0 40 0 0 40 0 0 

0 0 0 0 0 0 0 0 0 0 0 0 0 0 0 0 0 0 0 0 0 0 0 0 0 0 0 0 0 0 0 0 0 0 0 0 0 0 0 0 0 0 0 0 0 0 0 0 0 0 
0 0 0 0 0 0 0 0 0 0 0 0 0 0 0 0 0 0 0 0 0 0 0 0 0 0 0 0 0 0 0 0 0 0 0 0 0 0 0 0 0 0 0 0 0 0 0 0 0 0 
0 0 0 0 0 0 0 0 0 0 0 0 0 0 0 0 0 0 0 0 0 0 0 0 0 0 0 0 0 0 0 0 0 0 0 0 0 0 0 0 0 0 0 0 0 0 0 0 0 0 
0 0 0 0 0 0 0 0 0 0 0 0 0 0 0 0 0 0 0 0 0 0 0 0 0 0 0 0 0 0 0 0 0 0 0 0 0 0 0 0 0 0 0 0 0 0 0 0 0 0 
0 0 0 0 0 0 0 0 0 0 0 0 0 0 0 0 0 0 0 0 0 0 0 0 0 0 0 0 0 0 0 0 0 0 0 0 0 0 0 0 0 0 0 0 0 0 0 0 0 0 
0 0 0 0 0 0 0 0 0 0 0 0 0 0 0 0 0 0 0 0 0 0 0 0 0 0 0 0 0 0 0 0 0 0 0 0 0 0 0 0 0 0 0 0 0 0 0 0 0 0 
0 0 0 0 0 0 0 0 0 0 0 0 0 0 0 0 0 0 0 0 0 0 0 0 0 0 0 0 0 0 0 0 0 0 0 0 0 0 0 0 0 0 0 0 0 0 0 0 0 0 
0 0 0 0 0 0 0 0 0 0 0 0 0 0 0 0 0 0 0 0 0 0 0 0 0 0 0 0 0 0 0 0 0 0 0 0 0 0 0 0 0 0 0 0 0 0 0 0 0 0 
0 0 0 0 0 0 0 0 0 0 0 0 0 0 0 0 0 0 0 0 0 0 0 0 0 0 0 0 0 0 0 0 0 0 0 0 0 0 0 0 0 0 0 0 0 0 0 0 0 0 
0 0 0 0 0 0 0 0 0 0 0 0 0 0 0 0 0 0 0 0 0 0 0 0 0 0 0 0 0 0 0 0 0 0 0 0 0 0 0 0 0 0 0 0 0 0 0 0 0 0 
0 0 0 0 0 0 0 0 0 0 0 0 0 0 0 0 0 0 0 0 0 0 0 0 0 0 0 0 0 0 0 0 0 0 0 0 0 0 0 0 0 0 0 0 0 0 0 0 0 0 
0 0 0 0 0 0 0 0 0 0 0 0 0 0 0 0 0 0 0 0 0 0 0 0 0 0 0 0 0 0 0 0 0 0 0 0 0 0 0 0 0 0 0 0 0 0 0 0 0 0 
0 0 0 0 0 0 0 0 0 0 0 0 0 0 0 0 0 0 0 0 0 0 0 0 0 0 0 0 0 0 0 0 0 0 0 0 0 0 0 0 0 0 0 0 0 0 0 0 0 0 
0 0 0 0 0 0 0 0 0 0 0 0 0 0 0 0 0 0 0 0 0 0 0 0 0 0 0 0 0 0 0 0 0 0 0 0 0 0 0 0 0 0 0 0 0 0 0 0 0 0 
0 0 0 0 0 0 0 0 0 0 0 0 0 0 0 0 0 0 0 0 0 0 0 0 0 0 0 0 0 0 0 0 0 0 0 0 0 0 0 0 0 0 0 0 0 0 0 0 0 0 
0 0 0 0 0 0 0 0 0 0 0 0 0 0 0 0 0 0 0 0 0 0 0 0 0 0 0 0 0 0 0 0 0 0 0 0 0 0 0 0 0 0 0 0 0 0 0 0 0 0 
0 0 0 0 0 0 0 0 0 0 0 0 0 0 0 0 0 0 0 0 0 0 0 0 0 0 0 0 0 0 0 0 0 0 0 0 0 0 0 0 0 0 0 0 0 0 0 0 0 0 
0 0 0 0 0 0 0 0 0 0 0 0 0 0 0 0 0 0 0 0 0 0 0 0 0 0 0 0 0 0 0 0 0 0 0 0 0 0 0 0 0 0 0 0 0 0 0 0 0 0 
0 0 0 0 0 0 0 0 0 0 0 0 0 0 0 0 0 0 0 0 0 0 0 0 0 0 0 0 0 0 0 0 0 0 0 0 0 0 0 0 0 0 0 0 0 0 0 0 0 0 
0 0 0 0 0 0 0 0 0 0 0 0 0 0 0 0 0 0 0 0 0 0 0 0 0 0 0 0 0 0 0 0 0 0 0 0 0 0 0 0 0 0 0 0 0 0 0 0 0 0 
0 0 0 0 0 0 0 0 0 0 0 0 0 0 0 0 0 0 0 0 0 0 0 0 0 0 0 0 0 0 0 0 0 0 0 0 0 0 0 0 0 0 0 0 0 0 0 0 0 0 
0 0 0 0 0 0 0 0 0 0 0 0 0 0 0 0 0 0 0 0 0 0 0 0 0 0 0 0 0 0 0 0 0 0 0 0 0 0 0 0 0 0 0 0 0 0 0 0 0 0 
0 0 0 0 0 0 0 0 0 0 0 0 0 0 0 0 0 0 0 0 0 0 0 0 0 0 0 0 0 0 0 0 0 0 0 0 0 0 0 0 0 0 0 0 0 0 0 0 0 0 
0 0 0 0 0 0 0 0 0 0 0 0 0 0 0 0 0 0 0 0 0 0 0 0 0 0 0 0 0 0 0 0 0 0 0 0 0 0 0 0 0 0 0 0 0 0 0 0 0 0 
0 0 0 0 0 0 0 0 0 0 0 0 0 0 0 0 0 0 0 0 0 0 0 0 0 0 0 0 0 0 0 0 0 0 0 0 0 0 0 0 0 0 0 0 0 0 0 0 0 0 
0 0 0 0 0 0 0 0 0 0 0 0 0 0 0 0 0 0 0 0 0 0 0 0 0 0 0 0 0 0 0 0 0 0 0 0 0 0 0 0 0 0 0 0 0 0 0 0 0 0 
0 0 0 0 0 0 0 0 0 0 0 0 0 0 0 0 0 0 0 0 0 0 0 0 0 0 0 0 0 0 0 0 0 0 0 0 0 0 0 0 0 0 0 0 0 0 0 0 0 0 
0 0 0 0 0 0 0 0 0 0 0 0 0 0 0 0 0 0 0 0 0 0 0 0 0 0 0 0 0 0 0 0 0 0 0 0 0 0 0 0 0 0 0 0 0 0 0 0 0 0 
0 0 0 0 0 0 0 0 0 0 0 0 0 0 0 0 0 0 0 0 0 0 0 0 0 0 0 0 0 0 0 0 0 0 0 0 0 0 0 0 0 0 0 0 0 0 0 0 0 0 
0 0 0 0 0 0 0 0 0 0 0 0 0 0 0 0 0 0 0 0 0 0 0 0 0 0 0 0 0 0 0 0 0 0 0 0 0 0 0 0 0 0 0 0 0 0 0 0 0 0 
0 0 0 0 0 0 0 0 0 0 0 0 0 0 0 0 0 0 0 0 0 0 0 0 0 0 0 0 0 0 0 0 0 0 0 0 0 0 0 0 0 0 0 0 0 0 0 0 0 0 
0 0 0 0 0 0 0 0 0 0 0 0 0 0 0 0 0 0 0 0 0 0 0 0 0 0 0 0 0 0 0 0 0 0 0 0 0 0 0 0 0 0 0 0 0 0 0 0 0 0 
0 0 0 0 0 0 0 0 0 0 0 0 0 0 0 0 0 0 0 0 0 0 0 0 0 0 0 0 0 0 0 0 0 0 0 0 0 0 0 0 0 0 0 0 0 0 0 0 0 0 
0 0 0 0 0 0 0 0 0 0 0 0 0 0 0 0 0 0 0 0 0 0 0 0 0 0 0 0 0 0 0 0 0 0 0 0 0 0 0 0 0 0 0 0 0 0 0 0 0 0 
0 0 0 0 0 0 0 0 0 0 0 0 0 0 0 0 0 0 0 0 0 0 0 0 0 0 0 0 0 0 0 0 0 0 0 0 0 0 0 0 0 0 0 0 0 0 0 0 0 0 
0 0 0 0 0 0 0 0 0 0 0 0 0 0 0 0 0 0 0 0 0 0 0 0 0 0 0 0 0 0 0 0 0 0 0 0 0 0 0 0 0 0 0 0 0 0 0 0 0 0 
0 0 0 0 0 0 0 0 0 0 0 0 0 0 0 0 0 0 0 0 0 0 0 0 0 0 0 0 0 0 0 0 0 0 0 0 0 0 0 0 0 0 0 0 0 0 0 0 0 0 
0 0 0 0 0 0 0 0 0 0 0 0 0 0 0 0 0 0 0 0 0 0 0 0 0 0 0 0 0 0 0 0 0 0 0 0 0 0 0 0 0 0 0 0 0 0 0 0 0 0 
0 0 0 0 0 0 0 0 0 0 0 0 0 0 0 0 0 0 0 0 0 0 0 0 0 0 0 0 0 0 0 0 0 0 0 0 0 0 0 0 0 0 0 0 0 0 0 0 0 0 
0 0 0 0 0 0 0 0 0 0 0 0 0 0 0 0 0 0 0 0 0 0 0 0 0 0 0 0 0 0 0 0 0 0 0 0 0 0 0 0 0 0 0 0 0 0 0 0 0 0 
0 0 0 0 0 0 0 0 0 0 0 0 0 0 0 0 0 0 0 0 0 0 0 0 0 0 0 0 0 0 0 0 0 0 0 0 0 0 0 0 0 0 0 0 0 0 0 0 0 0 
0 0 0 0 0 0 0 0 0 0 0 0 0 0 0 0 0 0 0 0 0 0 0 0 0 0 0 0 0 0 0 0 0 0 0 0 0 0 0 0 0 0 0 0 0 0 0 0 0 0 
0 0 0 0 0 0 0 0 0 0 0 0 0 0 0 0 0 0 0 0 0 0 0 0 0 0 0 0 0 0 0 0 0 0 0 0 0 0 0 0 0 0 0 0 0 0 0 0 0 0 
0 0 0 0 0 0 0 0 0 0 0 0 0 0 0 0 0 0 0 0 0 0 0 0 0 0 0 0 0 0 0 0 0 0 0 0 0 0 0 0 0 0 0 0 0 0 0 0 0 0 
0 0 0 0 0 0 0 0 0 0 0 0 0 0 0 0 0 0 0 0 0 0 0 0 0 0 0 0 0 0 0 0 0 0 0 0 0 0 0 0 0 0 0 0 0 0 0 0 0 0 
0 0 0 0 0 0 0 0 0 0 0 0 0 0 0 0 0 0 0 0 0 0 0 0 0 0 0 0 0 0 0 0 0 0 0 0 0 0 0 0 0 0 0 0 0 0 0 0 0 0 
0 0 0 0 0 0 0 0 0 0 0 0 0 0 0 0 0 0 0 0 0 0 0 0 0 0 0 0 0 0 0 0 0 0 0 0 0 0 0 0 0 0 0 0 0 0 0 0 0 0 
0 0 0 0 0 0 0 0 0 0 0 0 0 0 0 0 0 0 0 0 0 0 0 0 0 0 0 0 0 0 0 0 0 0 0 0 0 0 0 0 0 0 0 0 0 0 0 0 0 0 
0 0 0 0 0 0 0 0 0 0 0 0 0 0 0 0 0 0 0 0 0 0 0 0 0 0 0 0 0 0 0 0 0 0 0 0 0 0 0 0 0 0 0 0 0 0 0 0 0 0 
0 0 0 0 0 0 0 0 0 0 0 0 0 0 0 0 0 0 0 0 0 0 0 0 0 0 0 0 0 0 0 0 0 0 0 0 0 0 0 0 0 0 0 0 0 0 0 0 0 0 
